111111111111111111111
1P0C00000000000000001
100000000000011100001
100C000E0000001110001
10000000000C001000001
100000000000000000001
111111111111111111111
